BL-Air		    :	features+, optim, mem, bugs, LockFree  - TODO: low cut filter
BL-AutoGain	    :	features+, optim, mem, bugs, LockFree
BL-Bat		    :
BL-Chroma	    :	features+, optim, mem, bugs, LockFree
BL-Denoiser	    :	features+, optim, mem, bugs, LockFree
BL-DUET		    :
BL-Envelope	    :	features+, optim, mem, bugs
BL-EQHack	    :	features+, optim, mem, bugs, LockFree
BL-Gain12	    :	features+, optim, mem, bugs
BL-Gain200	    :	features+, optim, mem, bugs
BL-Gain24	    :	features+, optim, mem, bugs
BL-Gain60	    :	features+, optim, mem, bugs
BL-Ghost	    :	features+, optim, mem, bugs, LockFree(legacy)
BL-GhostViewer	    :   features+,      , mem,     , LockFree
BL-Impulses	    :   features+, optim, mem, bugs, LockFree(lgacy)
BL-Infra	    :   features+, optim, mem, bugs, LockFree
BL-InfrasonicViewer :   features+, optim, mem, bugs, LockFree
BL-InfraSynth	    :
BL-LoFi		    :            , optim, mem, bugs, LockFree
BL-OnsetDetect	    :
BL-Panogram	    :   features+, optim, mem, bugs, LockFree
BL-PitchShift	    :
BL-Precedence	    :
BL-Rebalance	    :	wip: model is training
BL-Reverb	    :
BL-ReverbDepth	    :
BL-SampleDelay	    :
BL-SASViewer	    :
BL-Saturate	    :
BL-Shaper	    :
BL-Sine		    :
BL-SoundMetaViewer  :
BL-Spatializer	    :
BL-SpectralDiff	    :
BL-SpectroExpe	    :
BL-SpectrumView	    :
BL-StereoDeReverb   :
BL-StereoPan	    :
BL-StereoWidth	    :
BL-Wav3s	    :

---

DONE: 16
TODO: 12

TODO: pass valgrind for mem for all
